11111111111111111111
1P1000000000000E0001
101000000C0000000001
1C100000000000000001
10000000000011111111
11110000000000000C11
1C000000100000000001
101000001C0000000011
101000001C1111111111
11111111111111111111
