111111
1C1111
1P0011
100011
100001
1CC111
100011
111001
1C0001
1C0001
111101
100001
100011
10C0E1
111111
