11111111111111111111111111
100001C10000000000000000P1
10000101111001111111111111
1C0000000000000000000000C1
11111111111111011111000011
10000000000000010000000001
1E000100CC000011C1000C0001
11111111111111111111111111
