111111111111
10100E000001
1C1000010001
100000C1C0P1
111111111111
