11111
100C1
1C011
1P0E1
11111
